1111111111111111111
10010000000C0000001
1000011111000000001
1P0011E0000N0000001
1000100000111000001
1000000000000000001
10000C0000000000001
1000000000000000001
10000000000C0000001
1111111111111111111