111111111111111111111111
100P00000000000000000001
100000000000000C00000001
1000000000000000000000E1
111111111111111111111111