11111111111111111111111111111
1E0000000000C00000C00000000N1
10100101001000010010000010101
10100100101000010010000010101
1P0000000C00C00000000000000C1
100000000C00C00000000000000C1
10000000000000000001000000001
10000000000000000001000000001
10000000000100000001000000001
10000000000110000001000000001
1000000000N000000000000000001
11111111111111111111111111111