1111111
100000
1000001
1111111